Поле боя
Большое поле с укрытиями и стратегическими позициями
40 20
XXXXXXXXXXXXXXXXXXXXXXXXXXXXXXXXXXXXXXXX
X                                      X
X                                      X
X       E                       E      X
X                                      X
X    #####                    #####    X
X    #####                    #####    X
X    #####                    #####    X
X                                      X
X                                      X
X              ~~~~~~~~~~              X
X              ~~~~~~~~~~              X
X                                      X
X                                      X
X                                      X
X                                      X
X       E                       E      X
X                                      X
X                                      X
XXXXXXXXXXXXXXXXXXXXXXXXXXXXXXXXXXXXXXXX
