Классическая арена
Классическая карта для начинающих с балансом укрытий и открытых пространств
40 20
XXXXXXXXXXXXXXXXXXXXXXXXXXXXXXXXXXXXXXXX
X                                      X
X                                      X
X         E                   E        X
X                                      X
X    ##########                        X
X                                      X
X                                      X
X                        ~~~~~~~~~~    X
X                        ~~~~~~~~~~    X
X                                      X
X                                      X
X         **********                   X
X         **********                   X
X                                      X
X    ##########                        X
X                                      X
X                                      X
X                                      X
XXXXXXXXXXXXXXXXXXXXXXXXXXXXXXXXXXXXXXXX
