Crossroads
A central zone with multiple open approaches
40 20
XXXXXXXXXXXXXXXXXXXXXXXXXXXXXXXXXXXXXXXX
X          ##########                  X
X          ##########                  X
X          ##########                  X
X          ##########                  X
X                                      X
X                                      X
X                                      X
X                                      X
X    E     ############         E      X
X          ############                X
X          ############                X
X                                      X
X                                      X
X                          #########   X
X                          #########   X
X                          #########   X
X                          #########   X
X                                      X
XXXXXXXXXXXXXXXXXXXXXXXXXXXXXXXXXXXXXXXX
