Перекрёсток
Центральная зона с несколькими открытыми подходами
40 20
XXXXXXXXXXXXXXXXXXXXXXXXXXXXXXXXXXXXXXXX
X          ##########                  X
X          ##########                  X
X          ##########                  X
X          ##########                  X
X                                      X
X                                      X
X                                      X
X    E     ############         E      X
X          ############                X
X          ############                X
X          ############                X
X                                      X
X                                      X
X                                      X
X          #########                   X
X          #########                   X
X          #########                   X
X          #########                   X
X                                      X
XXXXXXXXXXXXXXXXXXXXXXXXXXXXXXXXXXXXXXXX