The Fortress
A fortified castle with complex defenses
40 20
XXXXXXXXXXXXXXXXXXXXXXXXXXXXXXXXXXXXXXXX
X                                      X
X                                      X
X                                      X
X                                      X
X    ###############                   X
X    #             #                   X
X    #             #                   X
X    #    E    E   #     ~~~~~~~~~~    X
X    #             #     ~~~~~~~~~~    X
X    #             #                   X
X    #             #                   X
X    ###############                   X
X                                      X
X                                      X
X ***                                  X
X ***                                  X
X ***                                  X
X                                      X
XXXXXXXXXXXXXXXXXXXXXXXXXXXXXXXXXXXXXXXX
