Labyrinth
A complex maze with narrow passages and dead ends
40 20
XXXXXXXXXXXXXXXXXXXXXXXXXXXXXXXXXXXXXXXX
X  #####     #####     #####     ##### X
X  # E #     #   #     #   #     # E # X
X  #   #     #   #     #   #     #   # X
X  #####     #####     #####     ##### X
X                                      X
X  #####     #####     #####     ##### X
X  #   #     #   #     #   #     #   # X
X  #   #     #   #     #   #     #   # X
X  #   #     #   #     #   #     #   # X
X  #####     #####     #####     ##### X
X                                      X
X  #####     #####     #####     ##### X
X  #   #     #   #     #   #     #   # X
X  # E #     #   #     #   #     # E # X
X  #   #     #   #     #   #     #   # X
X  #####     #####     #####     ##### X
X                                      X
X                                      X
XXXXXXXXXXXXXXXXXXXXXXXXXXXXXXXXXXXXXXXX
