Симметрия
Симметричная карта с зеркальным расположением объектов
40 20
XXXXXXXXXXXXXXXXXXXXXXXXXXXXXXXXXXXXXXXX
X                  ##                  X
X                  ##                  X
X        E         ##         E        X
X                  ##                  X
X    ##############  ##############    X
X    ##############  ##############    X
X                  ##                  X
X                  ##                  X
X                  ##                  X
X                  ##                  X
X                  ##                  X
X                  ##                  X
X    ##############  ##############    X
X    ##############  ##############    X
X               ##                     X
X        E      ##                     X
X               ##                     X
X               ##                     X
XXXXXXXXXXXXXXXXXXXXXXXXXXXXXXXXXXXXXXXX
