Test Run
A testing map with various terrain types for gameplay evaluation
40 20
XXXXXXXXXXXXXXXXXXXXXXXXXXXXXXXXXXXXXXXX
X                                      X
X                 XXXXXX               X
X                  XXXXXX              X
X                   XXXXXX             X
X    ###############                   X
X    #             #      ~~~~~~~      X
X    #             #                   X
X    #    E    E   #     ~~~~~~~~~~    X
X    #             #     ~~~~~~~~~~    X
X    #      ***    #                   X
X    #             #                   X
X    ###############   ~~~~~~~         X
X      ***             ~~   ~~         X
X         ***                 ~~       X
X ***                           ~~     X
X ***                                  X
X ***                                  X
X                                      X
XXXXXXXXXXXXXXXXXXXXXXXXXXXXXXXXXXXXXXXX
